['Plantae groenlandicae']	['Plantae groenlandicae']
['a Museo botanico Hauniensi distributae.']	['a Museo botanico Hauniensi distributae.']
['Chamærkerium latifolsen (L Scop.']	['Chamaenerion latifolium (L) Scop.']
['det Christensen.']	['det. Md.']
['Jørgtut. Nørlandet.']	['Ivigtut. Nordlandet.']
['5/8. 1829. Og. Lindhard.']	['5/8.1899. leg. Lindhard.']
['DEN DANSKE ARKTISKE STATION.']	['DEN DANSKE ARKTISKE STATION.']
['DISKO. GRØNLAND.']	['DISKO. GRØNLAND.']
['Saxifraga avfrides L.']	['Saxifraga aizoides (L.)']
['f. aurantia Hartm.']	['f. aurantia Hartm.']
['GROENL. OCCID. W. Disko, Nordfjorden,']	['GROENL. OCCID. W. Disko, Nordfjorden,']
["Storedal 69° 55' Lat. bor."]	["Storedal 69°55' Lat. bor."]
['9. August 1923.']	['9. August 1923.']
['A. E. Porsild.']	['A. E. Porsild.']
['Plantae groenlandicae']	['Plantae groenlandicae']
['a Museo botanico Hauniensi distributae.']	['a Museo botanico Hauniensi distributae.']
['lever nardina Fr. var. Opkrævning']	['Carex nardina fr. var. hepburnii']
['(Boot)']	['(Boott)']
["Groenl. Occ. Tasning 7325' N."]	["Groenl. occ. Tasiusak, 73°25'N."]
['4 Aug. 1916 var Thiesen Wulff']	['4 Aug. 1916 legit Thorild Wulff']
['Hierochloë alpina (Willd.) Roemer & Schultes']	['Hierochloë alpina (WILLD.) ROEMER & SCHULTES']
['ssp. alpina']	['ssp. alpina']
['Det. Gunnar Weimarck 1970']	['Det. Gunnar Weimarck 1970']
['Weimarck, G. 1971.½tering and Taxonomy of']	['WEIMARCK, G. 1971. Variation and Taxonomy of']
['Hierochloë (Gramineae) in the Northern Hemi-']	['Hierochloë (Gramineae) in the Northern Hemi-']
['sphere. – Bot. Notiser 124: 129—175.']	['sphere. - Bot. Notiser 124:129 - 175.']
['Hierochloe alpina (Sw.) Roem. et Sch. s. str.']	['Hierochloe alpina (Sw.) Roem. et Sch. s. str.']
['determ. Thorv. Sørensen (95L']	['determ. Thorv. Sørensen 1952']
['Vierochloa alpina']	['Hierochloa alpina']
['Rasm.']	['Boem.']
['in læes oprichs ad latera in']	['in locis arenosis apricis ad latera in']
['frøve algivne hans Jfortok.']	['feriora alpinum sinus Isortok']
['(Holst.) 1832 Aug.']	['(Holst.) 1832 Aug.']
['Universitetets botaniske Museum, København.']	['Universitetets botaniske Museum, København.']
['Museum botanicum Hauniense.']	['Museum botanicum Hauniense.']
['Arctic Plants']	['Arctic Plants']
['collected by the MORAVIAN BRETHREN 1847 - 1856.']	['collected by the MORAVIAN BRETHREN 1847 - 1856.']
['(See M. P Porsild: Stray Contributions to the Flora of Green-']	['(See M. P Porsild: Stray Contributions to the Flora of Green-']
['land XII. - Medd. om Gronl. Bd. 93, No. 3 (1935), p. 84-94)']	['land XII. - Medd. om Grønl. Bd. 93, No. 3 (1935), p. 84-94)']
['Potentilla tridentata']	['Potentilla tridentata']
['Ait.']	['Ait.']
['Grønland']	['Grónland']
['Rug J. Opfia']	['Reyfs Grfen']
['Ialt nd.']	['JHW.']
['Universitetets botaniske Museum, København.']	['Universitetets botaniske Museum, København.']
['Museum botanicum Hauniense.']	['Museum botanicum Hauniense.']
['Arctic Plants']	['Arctic Plants']
['collected by the MORAVIAN BRETHREN 1847 - 1856.']	['collected by the MORAVIAN BRETHREN 1847 - 1856.']
['(See M. P Porsild: Stray Contributions to the Flora of Green-']	['(See M. P Porsild: Stray Contributions to the Flora of Green-']
['land XII. - Medd. om Gronl. Bd. 93, No. 3 (1935), p. 84-94)']	['land XII. - Medd. om Grønl. Bd. 93, No. 3 (1935), p. 84-94)']
['Lycopodium opinem']	['Lycopodium alpinum']
['Trisetum spicatum (L.) Richt.']	['Trisetum spicatum (L.) Richt.']
['25.3.1979 Dec. Søren Hanfgarn']	['25.9.1979 Det. Søren Hanfgarn']
['Aira subfyndcata 1ste meger.']	['Aira subspicata B. major.']
['indtoges saaohos herthidus interetjøres']	['in locis sanosis subsicis sub. alpium']
['Nængartefungsæk førns Frantskeier']	['Nûgârssúnguaq sinus Baals Revier']
['1831 Aug.']	['1831 aug.']
['evt. E.x. Tradyodon A.Braun?']	['evt. E. x trachyodon A.Braūn?']
['Material insuff Laurent']	['Material insufficient']
['Døt; Harry Nielsen 199/']	['Det.: Henry Nielsen 1991']
['C. variegatum perhøj møre til at var. vi (gams) Elev maa)']	['E. variegatum perhaps more likely! var. wilsonii Newman?']
['dot. Maj 1931']	['det. Maj 1871']
['Number']	['Number']
['Specimen']	['Specimen']
['Locality']	['Locality']
['Altitude']	['Altitude']
['Date']	['Date']
['Collector']	['Collector']
['Plantae groenlandicae']	['Plantae groenlandicae']
['a Museo botanico Hauniensi distributae.']	['a Museo botanico Hauniensi distributae.']
['Equisetum variegatum Schlerch.']	['Equisetūm variegatūm Schleich.']
['I Vand.']	['I Vand.']
['Groenl. anstr: Ringua Tasersūk i Tasermiut']	['Groenl. austr.: Kingūa Tasersūak : Tasermiut']
['legit N. Hartz an. 1889. 2/9.']	['legit N.Hartz an. 1889 2/9']
['Herbarium musei botanici Hauniensis.']	['Herbarium musei botanici Hauniensis.']
['Lycopodium amtionum L.']	['Lycopodium annotinum L.']
['/3. alpestre Hartm.']	['B. alpestre Hartm.']
['Det. Joh. Sange.']	['Det. Joh. Lange.']
['in Louis hidtil Embapricas anbnedes']	['in locis siccis subapricis aitpedes']
['alpium samus Jortok Th. Holstb.']	['alpium sinus Isortok ft Holstb.']
['1832 Aug.']	['1832 Aug.']
['Univ, of Michigan']	['Univ, of Michigan']
['Woodsia ilvensis (L.) R. Br.']	['Woodsia ilvensis (L.) R. Br.']
['Sept, 1956']	['Sept, 1956']
['Donald F. M. Brown']	['Donald F. M. Brown']
['Woodsen ilvensis']	['Woodsia ilvensis']
['Fiskernæstet plokbøll 1843']	['Fiskesnæsfet Holboll 1843']
['Cystæptens fragilis (d. Berth.']	['Cystopteris fragilis (L.) Bernh.']
['ennend. Tim']	['emend. Lim']
['April 1931 Petersen, Kai Larsen']	['April 1959 determ. Kai Larsen']
['Herbarium musei botanici Hauniensis.']	['Herbarium musei botanici Hauniensis.']
['Cystopteris fragilis (L.) Bernh.']	['Cystopteris fragilis (L.) Bernh.']
['Nordgrørland 1861']	['Nordgrónland 1861']
['Arhverv (Udbympers Egede)']	['R. Brown (Whymper Exped.)']
['Plantae groenlandicae']	['Plantae groenlandicae']
['a Museo botanico Hauniensi distributae.']	['a Museo botanico Hauniensi distributae.']
['Carex capillariais L.']	['Carex capillaris L.']
['Groenl. orient. Scoresby Sund']	['Groenl. orient. Scoresby Sund.']
['Rosenvejenges Bugt']	['Rosenvinges Bugt.']
['20/8-1924.']	['20/8-1924']
['" O. Hagerup']	['legit O. Hagerup']
['Triglochen palustre']	['Triglochin palustre']
['in lodis hvori dis Jyds']	['in locis humidis Igaliko']
['1828 Aug.']	['1828 Aug.']
['L. Dansk geologisk og geografisk Undersøgelse']	['2. Dansk geologisk og geografisk Undersøgelse']
['af Grønland 1883.']	['af Grønland 1883.']
['Cystopteris fragilis var løbulak dentate']	['Cystopteris fragilis var. lobulato-dentata']
['6055 Ø. Gr. Ilenlek, 700 mødte alt']	["60°53' Ø. Gr. Iluileq, 700 meter alt."]
["(60° 51'"]	["(60°51')"]
['9. 4.']	['9. 4.']
['8. Aug.']	['8 Aug.']
['G. P. Eberlin']	['leg. P. Eberlin']
["65° 68' N, Kangerdluarsikajik"]	["65°68'N, Kangerdluarsikajik"]
['17.8,1899']	['17.8.1899']
['Natural History Museum of Denmark']	['Natural History Museum of Denmark']
['Herbarium C']	['Herbarium C']
['Image No. NHMD-694150']	['Image No. NHMD-694150']
['Plantae groenlandicae']	['Plantae groenlandicae']
['a Museo botanico Hauniensi distributae.']	['a Museo botanico Hauniensi distributae.']
['Expeditio Danica in Groenlandiam orientalem 1898—99.']	['Expeditio Danica in Groenlandiam orientalem 1898-99.']
['Lycopodium annotement']	['Lycopodium annotinum']
['3 paengens Desv.']	['B pungens (some word)']
['Læg. C. Krunse.øt kan gikapik.']	['Leg. C. Kruuse. ad Kangerdluarsikajik']
["65° 58'00"]	["65°68'N"]
['17 Aug 1899']	['17 Aug 1899']
['Aira subspicata']	['Aira subspicata']
['in lodes opvides hans Kangert.']	['in locis apricis sinus Kangerd']
['Aarhuk (Kobbefjorden) 1830 Juli']	['luarsuk (Kobbefiorden) 1830 Juli']
['Universitetets Botaniske Museum, København.']	['Universitetets Botaniske Museum, København.']
['Museum botanicum Hauniense.']	['Museum botanicum Hauniense.']
['Botanisk Rejse til Vest-Grønland 1932.']	['Botanisk Rejse til Vest-Grønland 1932.']
['Phippsia algida (Sol.) R. Br.']	['Phippsia algida (Sol.) RBr.']
['Disco: Husnet, Diskafførd, i Elveje.']	['Disko: Kuanit, Diskofjord, i Elvleje.']
['No 6/Vn. 1/11 et del. Johs. Græntved.']	['No  6/VIII.  leg. et det. Johs. Grøntved.']
['Kobresia Bellardi (All.) Dejl']	['Kobresia bellardii (All.) Degl.']
["Mianaitninguag 70° 22'"]	["Atanaitsunguaq 70°22'"]
['4-8-1921 ØE Porsild']	['4-8-1921 A E Porsild']
['Læsk, Jokobsen']	['Herb. Joh.Lange']
['Paa planer Vahl']	['Poa glauca Vahl']
['B, datior Lye.']	['B. elatior Lge.']
['Flermelik (Bredefjord) i True Udefel']	['Sermilik (Bredefjord) i Tunudliorfil']
['Tørv. 28 Jul 1876 (Korrup)']	['Fjord. 28 Juli 1876 (Kornerup)']
['Truentine subspicitation 6/4 Sørensen Jakobsen 4/8 1892']	['Trisetum sūbspicaticūm P.A.Sórensen Jakobshavn 4/8 1892']
['Revisions studies in the Genus Woodsia (Aspidiaceae)']	['Revisionary Studies in the Genus WOODSIA (Aspidiaceae)']
['W. glabella R.Brown']	['W. glabella R.Brown']
['Sept. 1956']	['Sept. 1956']
['Donald F. M. Brown, University of Michigan.']	['Donald F. M. Brown, University of Michigan.']
['Plantae groenlandicae']	['Plantae groenlandicae']
['a Museo botanico Hauniensi distributae.']	['a Museo botanico Hauniensi distributae.']
['Woodsia glabella R. Br.']	['Woodsia glabella R. Br.']
['det. Joh. Lge.']	['Det. Joh. Lge.']
["Kingarsūak 70° 43' n.Br."]	["Kingarsuak 70°43' n.Br."]
['7. Aug. 1888. læst: S. Hansen']	['7. aug. 1888 legit S. Hansen']
['Calamagrostis neglecta (Sturh.)']	['Calamagrostis neglecta (Ehrh.)']
['determ. Thorv. Sørensen 1939°f']	['determ. Thorv. Sørensen 1954']
['Catamager neglecta']	['Calamagr. neglecta']
['1926 determ. C. H. Ostenfeld.']	['1926 determ. C. H. Ostendeld.']
['DEN DANSKE ARKTISKE STATION.']	['DEN DANSKE ARKTISKE STATION.']
['DISKO, GRØNLAND.']	['DISKO, GRØNLAND.']
['Calamagrostis hyperborea']	['Calamagrostis Lyperborea']
['Lange']	['Lange']
['Syd-Grønl. Qagssiarssuk, Igaliko-Fjord, 60"53\' N.']	["Syd-Grønl. Qagssiarssuk, Igaliko-Fjord, 60° 53' N."]
['5. Aug. 1925.']	['5. Aug. 1925.']
['A. E. Porsild & M. P.Porsild.']	['A. E. Porsild & M. P. Porsild.']
['Museum botanicum']	['MUSEUM BOTANICUM']
['HAUNIENSE.']	['HAUNIENSE.']
['Carex ampullacea. Good.']	['Carex ampullacea. Good.']
["In Groenlandia meridionalis sinibus 61° 2'"]	["In Groenlandiæ meridionalis sinibus 67° 2'."]
['J. Vahl.']	['J.Vahl.']
['FORGIFTET.']	['FORGIFTET.']
['redies alpium']	['radices alpium']
['Jens Jesarmiut.']	['sinus Tasermiut.']
['Leg. J. Vahl 1829. Aug.']	['Leg. J. Vahl 1829. Aug.']
['Botanic Museum of the University, Copenhagen']	['Botanic Museum of the University, Copenhagen']
['Greenland Plants']	['Greenland Plants']
['The triennial Danish Expedition to East Greenland 1931—34.']	['The triennial Danish Expedition to East Greenland 1931 - 34.']
['36 53731 angulv Corfusa Lindel.']	['No 5373. Luzula confusa Lindeb.']
["Lat 7/0 35' N"]	["Lat 71°35'N"]
["Long. 22° 25' W."]	["Long. 22°25'N"]
['Alt.']	['Alt.']
['Loc. Canning Land: The Zithnus Christensen']	['Loc. Canning Land: The Isthmus between']
['Lundberg Tjork. and Vithuset Fjord.']	['Carlsbay Fjord and Nathorst Fjord.']
['Date: 30. Ⅱ 1934']	['Date: 30. VII 1934']
['leg. Thorv. Sørensen']	['Leg. THORV. SØRENSEN']
['Det. Nr. 5.']	['Det. Th. S.']
['Paa prat anfis amokrepartion']	['Poa pratensis macrorrhiza']
['ceursia.']	['ianisia']
['Wahl']	['Wahl']
['in Louis fortitions Janus.']	['in locis fertilioribus sinus']
['Amnavalik 1830 Aug']	['Amaralik 1830 aug.']
['P. Mortensen']	['P. pratensis']
['Paa flexnosa var elongste Blyk']	['Poa flexuosa var. elongata Alyth']
['D. L.']	['J.L.']
['1876']	['1876']
['Aspidium Finke maa (Ensd)']	['Aspidium Filix mas (L. / Sw)']
["Sydgrønland, Paalagaluk 59° 55'"]	["Sydgrönland, Paniagaluk 59° 55'."]
['1891 Eleonora Lundholm.']	['1891 Eleonora Lundholm.']
['Universitetets botaniske Museum, København.']	['Universitetets botaniske Museum, København.']
['Museum botanicum Hauniense.']	['Museum botanicum Hauniense.']
['Arctic Plants']	['Arctic Plants']
['Universitatis carolinae botanicae cathedra, fraga']	['UNIVERSITATIS CAROLINAE BOTANICAE CATHEDRA, PRAGA']
['Poa glauca Vahl']	['Poa glauca Vahl']
['29.11. 1963']	['29. 11. 1963']
['Paa nemoralis L.']	['Poa nemoralis L.']
['var glana.']	['var. glauca']
['Loktenfals Groslaar']	['Lichtenfels Gronland']
['Nifson. Tætgen.']	['Mission. Tietzen']
['1853']	['1853']
['Plantae groenlandicae']	['Plantae groenlandicae']
['a Museo botanico Hauniensi distributae.']	['a Museo botanico Hauniensi distributae.']
['Expeditio Danica in Groenlandiam orientalem 1901—2. E 3']	['Expeditio Danica in Groenlandiam orientalem 1901-2. E3']
['Chamaener, som latifolien']	['Chamaenerion latifolium']
['(L) Spach']	['(L) Spach']
["Læg. C. Kruuse ad. Kan gav nok 66° 10'"]	["Leg. C. Kruuse ad. Kingarsuak 66°10'"]
['22 Juni 1902']	['22 juni 1902']
['367. Plantae groenlandicae']	['367. Plantae groenlandicae']
['a Museo botanico Hauniensi distributae.']	['a Museo botanico Hauniensi distributae.']
['Do alpinaa.']	['Poa alpina L.']
['I det indre af Dalen Ø. J. Agder']	['I det indoe af Dalen Ø.f. Igdlor-']
['pårt']	['pait']
['GRøENl. occideret.; Disco, N.V. Kysblen.']	['GROENL. OCCIDENT.; Disco, N.V. Kysten.']
['26. 7. 1902. Nr. Morten P. Porsild.']	['26. 7. 1902 leg. Morten P. Porsild.']
['DEN DANSKE ARKTISKE STATION.']	['DEN DANSKE ARKTISKE STATION.']
['DISKO. GRØNLAND.']	['DISKO. GRØNLAND.']
['Carex holostoma']	['Carex holostoma']
['Boede Bugt N. J. Jakobshavn']	['Brede Bugt n. f. Jakobshavn']
["69° 18'"]	["69° 18'"]
['6/8 1915']	['6/8 1915']
['leg. Morten P. Porsild.']	['leg. Morten P. Porsild.']
['Herbarium musei botanici Hauniensis.']	['Herbarium musei botanici Hauniensis.']
['Junens castanens Sm.']	['Juncus castaneus Sm.']
['Nordgederland 1867 (Jacobshavn)']	['NordGronland 1867 (Jakobshavn)']
['R. Worm (Wognepart Egged.)']	['R. Brown (Whymper Exped.)']
['Universitetets botaniske Museum, København.']	['Universitetets botaniske Museum, København.']
['Museum botanicum Hauniense.']	['Museum botanicum Hauniense.']
['Arctic Plants']	['Arctic Plants']
['collected by the MORAVIAN BRETHREN 1847 - 1856.']	['collected by the MORAVIAN BRETHREN 1847 - 1856.']
['(See M. P Porsild: Stray Contributions to the Flora of Green-']	['(See M. P Porsild: Stray Contributions to the Flora of Green-']
['land XII. - Medd. om Gronl. Bd. 93, No. 3 (1935), p. 84-94)']	['land XII. - Medd. om Grønl. Bd. 93, No. 3 (1935), p. 84-94)']
['Aira alpina L']	['Aira alpina L.']
['Lichtenfals in Grønland']	['Lichtenfels in Gronland']
['Milsvare Jætges']	['Mifsiona Tietzen']
['1853']	['1853']
['Nøra alpina L.']	['Aira alpina L.']
['Liktenfels in Groslaaad']	['Lichtenfels in Gronland']
['Niels Jespersen']	['Mifsiona Tietzen']
['1853 -']	['1853']
['Universitetets botaniske Museum, København.']	['Universitetets botaniske Museum, København.']
['Museum botanicum Hauniense.']	['Museum botanicum Hauniense.']
['Plantae Groenlandicae.']	['Plantae Groenlandicae.']
['Carex nardina Fr.']	['Carex nardina Fr.']
['det° Ctt.U']	['det. etto.']
['N. V. Grørland, Holstenholme Søren,']	['N.V.Gronland, Wolstenholme Sound,']
['Sønder Kl. Appat']	['Saunders Isl.: Agpat']
['12 - 7. 1911']	['12.7.1911']
['1ste Peter Fruetten']	['leg. Peter Freuchen']
['Familie: Saxifragassal']	['Familie: Saxifragaceae']
['Dansk navn: Hugo - Blenbroek']	['Dansk navn: Knoje - Stenbræk']
['Latinsk navn: Kartifraga cernusa']	['Latinsk navn: Saxifraga cernua']
['Taxation: Jørgen Brønlund og Pearyland']	['Lokalitet: Jòrgen Brònlund Fj. Pearyland']
['Voksøplads (samt): Fru. maa v. Keddelkasselr']	['Vokseplads (samf.): Fu. Ruos r. Keddelkrogelr']
['Dato: 4-7 Rinder: Jean Just']	['Dato: 4-7 Findere: Jean Just']
['66']	['66']
['1.C.P.']	['I.C.P.']
["82° 10' N 30° 30' W"]	["82°10'N 30°30'W"]
['Flora Groenlandica.']	['Flora Groenlandica.']
['Festuca rubra L.']	['Festuca rubra L.']
['Uvebrænstedet Jordsensak Julius Distrikt']	['Overburestedet Itivdliarssuk Julianehaabs Distrikt']
['13/7 1897.']	['13/7 1897.']
['leg. Gustav Meldorf.']	['leg. Gustav Meldorf..']
['DEN DANSKE ARKTISKE STATION.']	['DEN DANSKE ARKTISKE STATION']
['DISKO, GRØNLAND.']	['DISKO, GRØNLAND.']
['Over vaginata']	['Pucc. Vaginata']
['det Th S 1949']	['det Th S 1949']
["Vest-Grønl. Qaumarujuk Fjord, Øingua,71° 7' N."]	["Vest-Grønl. Qaumarujuk Fjord, Qingua, 71° 7' N."]
['27. Juli 1935,']	['27. Juli 1935,']
['M. P. Porsild.']	['M. P. Porsild.']
['DEN DANSKE ARKTISKE STATION.']	['DEN DANSKE ARKTISKE STATION']
['DISKO. GRØNLAND.']	['DISKO, GRØNLAND.']
['Salix glauca L']	['Salix glauca L']
["GROENL. OCCID. ca. Maria 61° 33' lat. bor."]	["GROENL. OCCID. ca. Neria 61° 33' lat. bor."]
['12/7 1924']	['12/7 1924']
['leg. J. Eugenius.']	['leg. J.Eugenius.']
['Trisetum triflorum (Bigel.) Löve & Løve']	['Trisetum triflorum (Bigel.) Löve & Löve']
['12.11.1979']	['12.11.1979']
['Det. Jon Feilberg']	['Det. Jon Feilberg']
['Aira subspicata']	['Aira Subspicata']
['in localis opnises Nennelse.']	['in locis apricis Nennese']
['1829 Juli.']	['1829 Juli.']
['Dansk geologisk Undersøgelse af Grønland 18 78']	['Dansk geologisk Undersøgelse af Grønland 1878']
['Betula nana L.']	['Betula nana L.']
['Utilivik paa Nordsiden af Fiskernæs-']	['Utilivik paa Nordsiden af Fiskernæs-']
['Fjorden']	['Fjorden.']
['5 Jun.']	['5 Jun.']
['A. Kornerup.']	['A. Kornerup.']
['D. arctica']	['d. arctica']
['L. Kock']	['L. Koch']
['21/7. 16']	['21/7.16']
['Universitetets botaniske Museum, København.']	['Universitetets botaniske Museum, København.']
['Museum botanicum Hauniense.']	['Museum botanicum Hauniense.']
['Plantae Groenlandicae.']	['Plantae Groenlandicae.']
['Dekmannpris respikra L.P. Blan.']	['Deschampsia caespitosa (L) P. Beauv.']
['vart arctica (Trin.) Simm.']	['var. arctica (Tsin.) Simu.']
['Wilfreml. Valstenholme Smed:']	['NW Greenl., Walstenkoline Sound:']
['Umanag, old dog stemte']	['Umanaq, old dry skingle']
['ved.']	['bed.']
['21. J. 1916.']	['21.7.1916.']
['leg.']	['leg.']
['Lange kort.']	['Lange Koch']
['Grifetum hylvatilum']	['Equisetum sylvaticum']
['Limmé']	['Linné']
['in lois forbeholder udvadiges']	['in locis subhumidis ad radices']
['alpium førns Amalik']	['alpium sinus Amaralik']
['Lig. J. Dahl.']	['Leg. J.Vahl']
['1831 Juli']	['1831 Juli']
['Plantae groenlandicae']	['Plantae groenlandicae']
['a Museo botanico Hauniensi distributae.']	['a Museo botanico Hauniensi distributae.']
['Expeditio Danica in Groenlandiam orientalem 1901—2.']	['Expeditio Danica in Groenlandiam orientalem 1901-2.']
['E3']	['E3']
['Chamaerneins latifolisen']	['Chamaenerium latifolium']
['(L) Spach.']	['(L.) Spach.']
['f. stenapitala']	['f. stenopetala']
["Ley. C. Kruuse ad. Henck 65° 56'"]	["Leg. C. Kruuse ad. Tunak 65°55'"]
['6 Aug 1902']	['6 Aug 1902']
['Universitetets botaniske Museum, København.']	['Universitetets botaniske Museum, København.']
['Museum botanicum Hauniense.']	['Museum botanicum Hauniense.']
['„Danmark” Expeditionen, 1906—1908. 237']	['„Danmark" Expeditionen, 1906-1908. 237']
['Junens brylumis L.']	['Juncus biglumis L.']
['det C.H.U.']	['- det. etto.']
['Groenlandia bor-orient.: Kæret ved Vester Ho']	['Groenlandia bor.-orient.: Kæret ved Vester Elv']
['17 Juli 1907 beg. Andr. Løndager']	['17 Juli 1907 leg. Andr. Lundager.']
['Museum botanicum']	['MUSEUM BOTANICUM']
['HAUNIENSE.']	['HAUNIENSE.']
['Carea ampullacea Good. Forgifter']	['Carex ampullacea. Good. FORGIFTET.']
['in paludofis ad']	['In paludosis ad']
['redises algivne']	['nadices alpium']
['lenus Igaliko -']	['sinus Igaliko.']
['Leg. 1. Nahl. 1828. Aug.']	['Leg. J. Vahl 1828. Aug.']
['Universitetets botaniske Museum, København.']	['Universitetets botaniske Museum, København.']
['Museum botanicum Hauniense.']	['Museum botanicum Hauniense.']
['Jubilæums Expeditionen Nord om Grønland 1920—1923.']	['Jubilæums Expeditionen Nord om Grønland 1920-1923.']
['Puccinellia desangaaendes (Trin) Skrivelse.']	['Puccinellia phryganodes (Trin.) Scribn.']
['xhen.']	['& Merr.']
['N. W. Greenland: Husleugten Land, P Morsnok']	['N.W. Greenland: Washington Land, Pustersnack']
['N. Lat. c,80°,']	['N. Lat.: e.80°,']
['Lange Mark']	['Lauge Koch']
['-3/8 1921.']	['13/8 1921.']
['leg. J.Noe Nygaard']	['leg. [J. Noe Nygaard.]']
['determ. C. H. Ostenfeld.']	['determ. C. H. Ostensfeld.']
['Botanic Museum of the University, Copenhagen']	['Botanic Museum of the University, Copenhagen']
['Greenland Plants']	['Greenland Plants']
['The Triennial Danish Expedition to East Greenland 1931 – 34.']	['The triennial Danish Expedition to East Greenland 1931 - 34.']
['30 55 Kr. Emphorum f. Hjortshøj til']	['No 55 12. Eriophorum polystachyum L.']
['var trulis Th. Fr.']	['var. tristis Th Fr.']
["lat 24° 06'"]	["Lat 74° 06'N"]
["Long. 21° 20' W"]	["Long. 21°20'W"]
['Alt. 75 m.']	['Alt. 75 m.']
['Lov. Clavering til: V. W. J. Erhvervssen']	['Loc. Clavering Isl: N.W. of Eskimonæs']
['Date: 20.VII 1935']	['Date: 20.VII 1935']
['leg. Thorv. Sørensen']	['Leg. THORV. SØRENSEN']
['Det. 7½ S.']	['Det. Th S/.']
['S flagelleris Willd.']	['S. flagellaris Willd']
['ssp. platysepala (Trautv.) Pors.']	['ssp. platysepala (Trautv.) Pors.']
['Determ.: Eric Hultén. 1963']	['Determ.: Eric Hultén. 1963']
['Zweite Deutsche Nordpol-Expedition 1869-70.']	['Zweite Deutsche Nordpol-Expedition 1869-70.']
['Expeditions Schiff ”,Germania."']	['Expeditionsschiff,,Germania."']
['Saxifr. flagellævis Willd']	['Saxifr. Flagellaris Willd']
['Oestliches Grönland: Sabine-Insel, Plævering Ensol']	['Oestliches Grönland: Sabine-Insel, [Clavering Insel.]']
['FORGIFTET.']	['FORGIFTET.']
['Plantae groenlandicae']	['Plantae groenlandicae']
['a Museo botanico Hauniensi distributae.']	['a Museo botanico Hauniensi distributae.']
['Expeditio Danica in Groenlandiam orientalem 1901—2. E 3']	['Expeditio Danica in Groenlandiam orientalem 1901-2. E3']
['Chamaencriserne latifolisen']	['Chamaenerion latifolium']
['(Læs paa)']	['(L) Spoch']
["Lov. C. Knudsen ad. Skemaesench 66° 8'"]	["Leg. C. Kruuse ad. Ikerasausak. 66° 5'"]
['30 Juni 1902']	['30 Juni 1902']
['Universitetets botaniske Museum, København.']	['Universitetets botaniske Museum, København.']
['Museum botanicum Hauniense.']	['Museum botanicum Hauniense.']
['Plantae Groenlandicae.']	['Plantae Groenlandicae.']
['Lokale confusa']	['Luzula confusa']
['ret.U.V.']	['det. ett. o.']
['V. Grøstand,�iereske og Søren']	["V. Grónland, Giesecke's Sø ved"]
['Nordre Strømfjord (Dydestlige Fred)']	['Nordre Strømfjord (sydvestlige Bred).']
['11-8-1911° V. Nordemann']	['11-8-1911 leg. V. Nadmann']
['Universitetets botaniske Museum, København.']	['Universitetets botaniske Museum, København.']
['Museum botanicum Hauniense.']	['Museum botanicum Hauniense.']
['Plantae Groenlandicae.']	['Plantae Groenlandicae.']
['Carex rupestris All-']	['Carex rupestris All.']
['Nielsgaard. Holstenholme Svend:']	['N.W. Greenl. Wolstenholme Sound:']
['Umanag.']	['Umanaq.']
['7.8.19163ocdange Novb.']	['7.8.1916 leg. Lange Koch.']
['Epilobium lactiflorum Hausskn.']	['Epilobium lactiflorum Hausskn.']
['Determined by Peter C. Hoch']	['Determined by Peter C. Hoch']
['Missouri Botanical Garden 1977']	['Missouri Botanical Garden 1977']
['8 31.']	['831.']
['Epilobium Formemanni']	['Epilobium Hornemanni']
['flalradovica Hansskri-']	['f. Lubradorica Hausskn.']
['Disko, mellem fjord, Komstedet']	['Disko, Mellemfjord, Kvindstedet']
['12.8.1902.']	['12.8.1902']
['M. Porsild.']	['MP. Porsild.']
['No 1 1 i 10']	['Nr.11100']
['25']	['25']
['Aloprens']	['Alopecurus']
['alpinus']	['alpinus']
['Eng af Købberaa']	['Eng v/ Kobberaa']
['imle']	['Thule']
['30/7 39']	['30/7 39']
['lig. Thorlekasson.']	['leg. Thorlaksson']
['Den danske Thule-Ellesmere Land Ekspedition']	['Den danske Thule-Ellesmere Land Ekspedition']
['Botanic Museum of the University, Copenhagen']	['Botanic Museum of the University, Copenhagen']
['Plants of Northwest Greenland']	['Plants of Northwest Greenland']
['From the Danish Thule-Ellesmere Land expedition']	['From the Danish Thule-Ellesmere Land expedition']
['1939-40.']	['1939-40.']
['Prikket C. Bay']	['PRIKKET C. BAY']
['Alopecurus alpinus Sm.']	['Alopecurus alpinus Sm.']
['Eng.']	['Eng.']
['Alt.']	['Alt.']
['Loc. Kobberå, Dundas']	['Loc. Kobberå, Dundas']
["c. 76° 34' N. 68° 48' W."]	["c. 76°34' N. 68°48' W."]
['Date: 30.7.39 No. 11125']	['Date. 30.7.39 No. 11125']
['leg. G. Thorláksson']	['Leg. G. Thorláksson']
['Det. K. Jakobsen']	['Det. K. Jakobsen']
['Poa nemoralis']	['Poa nemoralis']
['G.A. Sørensen']	['P.H. Sorensen']
['Egedesvius Juli 1894.']	['Egedesminde Juli 1894']
['Epilobium hornemannii Reichenb.']	['Epilobium hornemannii Reichenb.']
['subsp. hornemannii']	['subsp. hornemannii']
['Deremined by Peter C. Hoch']	['Determined by Peter C. Hoch']
['Missouri Botanical Garden']	['Missouri Botanical Garden']
['1978']	['1978']
['DEN DANSKE ARKTISKE STATION.']	['DEN DANSKE ARKTISKE STATION.']
['DISKO. GRØNLAND.']	['DISKO. GRØNLAND.']
['Epilobium Hornemanni']	['Epilobium hornemannii']
['Godhaven']	['Godhavn']
['Disko, 24.8.1912']	['Disko, 24.8.1912']
['leg. Thorbjørn Porsild.']	['leg. Thorbjørn Porsild.']
['DEN DANSKE ARKTISKE STATION.']	['DEN DANSKE ARKTISKE STATION.']
['DISKO, GRØNLAND.']	['DISKO. GRØNLAND.']
['Capsella bursa pastoris (L.)']	['Capsella bursa pastoris (L.)']
['Med.']	['med.']
['Syd-Grønl. Narssaq, Tunugdliarfik-Fjord, 60" 55\' N.']	["Syd-Grønl. Narssaq, Tunugdliarfik-Fjord, 60° 55' N."]
['8. Aug. 1925.']	['8. Aug. 1925.']
['A. E.Porsild & M. P. Porsild,']	['A. E. Porsild & M. P. Porsild.']
['museum botanicum']	['MUSEUM BOTANICUM']
['HAUNIENSE.']	['HAUNIENSE.']
['laren rigida Gooden.']	['Carex rigida Gooden.']
['handilis Drej.']	['saxatilis Drej.']
['FORGIFTET.']	['FORGIFTET.']
['leg. I.Vahl 1834. Aug.']	['Leg. J.Vahl 1834. Aug.']
['ad tatera inferie.']	['ad later inferio']
['ra algivne Ferri']	['ra alpinum Terri']
['Tori calen. Uperne']	['Torii colon. Uperni']
['vik -']	['vik -']
['Dansk geologisk og geografisk Undersøgelse']	['Dansk geologisk og geografisk Undersøgelse']
['af Grønland 1885']	['af Grønland 1885.']
['Lycopedium annotinum sk, alpothe']	['Lycopodium annotinum ß. alpestre']
['16 g.']	['Wg.']
['el. Grønl. Kunguk do 65']	['V. Gronl. Kunguk. ca 65°']
['3 Jun.']	['3 Jun']
['b. S. Hansen']	['by. S. Hansen']
['flora of thule']	['FLORA OF THULE']
['region of Etah']	['REGION OF ETAH']
['No. 83']	['No. 83']
['Paa glauca Vahl.']	['Poa glauca Vahl.']
['Røcky delte, Etah.']	['Rocky delta, Etah.']
['Aug. 13, 1915.']	['aug. 13, 1915.']
['W. Elmer Ekblaw']	['W. ELMER EKBLAW']
['Chockerland Expedition']	['CROCKERLAND EXPEDITION']
["Lititude 78° 20' W"]	["Latitude 78°20' N"]
["Langitrude 7° 30' W"]	['Longitude 72°30 N']
['Universitetets botaniske Museum, København.']	['Universitetets botaniske Museum, København.']
['Museum botanicum Hauniense.']	['Museum botanicum Hauniense.']
['Plantae Groenlandicae. 1895']	['Plantae Groenlandicae. 1495']
['Carex rariflora (Wgl. Smith']	['Carex rariflora (Wg) Smith']
['Laksefjord 26/8 1911']	['Laksefjord 26/8 1911']
['Andr. Lundager']	['leg. Andr. Lundager']
['ALFRED BENZON']	['ALFRED BENZON']
['H. T. V.']	['Yl. Fe. vi.']
['522 - 1']	['J22-1']
['Aspind: Sonchitis.']	['Aspid. Lonchitis']
['Godhavn. Disco. 69?']	['Godhavn. Disco. 69°.']
['1864. Fabita Broberg']	['1864. Tabita Broberg']
['KJÖBENHAVN.']	['KJÖBENHAVN.']
['Fra Universitetets Botaniske Museum, København.']	['Fra Universitetets Botaniske Museum, København.']
['E Museo Botanico Hauniense.']	['E Museo Botanico Hauniense.']
['Botanical Investigations in West-Greenland 1932.']	['Botanical Investigations in West-Greenland 1932.']
['Carex lagopina Viby.']	['Carex lagopina Whbg.']
['Disko: Lonthe coast, at Langfik']	['Disko: South coast, at Sinigfik']
['ca. 3 km from den saa shore']	['ca. 3 km from the sea shore.']
['No 201 24/VI.']	['No 207 24/VI.']
['leg. et det. Johs. Grøntved.']	['leg. et det. Johs Grøntved.']
['Universitetets botaniske Museum, København.']	['Universitetets botaniske Museum, København.']
['Museum botanicum Hauniense.']	['Museum botanicum Hauniense.']
['Arctic Plants']	['Arctic Plants']
['collected by the MORAVIAN BRETHREN 1847 - 1856.']	['collected by the MORAVIAN BRETHREN 1847 - 1856.']
['(See M. P Porsild: Stray Contributions to the Flora of Green-']	['(See M. P Porsild: Stray Contributions to the Flora of Green-']
['land XII. - Medd. om Gronl. Bd. 93, No. 3 (1935), p. 84-94)']	['land XII. - Medd. om Grønl. Bd. 93, No. 3 (1935), p. 84-94)']
['Poa alpina L.']	['Poa alpina L.']
['Lohtenfals Grønland']	['Lichtenfels in Gronland']
['Mifts øn. Tietzen']	['Mission Tietzen']
['1853']	['1853']
['Natural History Museum of Denmark']	['Natural History Museum of Denmark']
['Herbarium C']	['Herbarium C']
['Image No. NHMD-81188']	['Image No. NHMD-811868']
['FORGIFTET.']	['FORGIFTET.']
['ALFRED BENZON']	['ALFRED BENZON']
['He. Le. vi 483.7.']	['ye. fe. vi. 483. of.']
['Do Barifalias']	['5 Brevifolia']
['Pestuca ordinær L']	['Festuca ovina L']
['Godhavn Disco']	['Godhavn Disco']
['69° N.B.']	['69° N. Ø.']
['1864. Sabita Brogh']	['1864 Tabita Broberg']
['KJÖBENHAVN.']	['KJÖBENHAVN.']
['1 S F']	['! SF']
['Festuca brachyphylla Schultes W. 5']	['Festuca brachyphylla Schultes W.5']
['1962 det. Kjeld Holmen']	['1962 det. Kjeld Holmen']
['Festuca brevifolia R.Or.']	['Festuca brevifolia\xa0R.Br.']
['1 Schol. 1933.']	['! Schol. 1933.']
['us national herbarium (us)']	['US NATIONAL HERBARIUM (US)']
['Poa flexuosa ssp. consauliae L. J.']	['Poa flexuosa ssp. consauliae L. J.']
['Gillaspie & Soreng']	['Gillespie & Soreng']
['toward P. glauca Vahl']	['toward P. glauca Vahl']
['Det.: R. J. Soreng, 2017']	['Det.: R. J. Soreng, 2017']
['Herbarium AAU, Botanical Institute, University of Aarhus']	['Herbarium AAU, Botanical Institute, University of Aarhus']
['No.']	['No.']
['Paa fluxa sn.']	['Poa flexuosa Gn']
['C/19,9 Simon Lægaard']	['6/1989 Simon Lægaard']
['Pn dauge']	['Poa glauca']
[' Mary Thorv. Sørensen det J. Vanafaldt']	['Serv Thorv. Sørensen det. J. Naunfeldt']
['6953']	['1953']
['Dansk geologisk og geografisk Undersøgelse']	['Dansk geologisk og geografisk Undersøgelse']
['af Grønland.']	['af Grønland.']
['Poa laxinscula Lge.']	['Poa laxiuscula Lge.']
['V. Grønland: Holsteinsborg']	['V. Grónland: Holsteinsborg']
['6 Aug.']	['6 Aug.']
['samlet paa ”Fyllæs” Tøgt 1884 af']	["samlet paa „Fylla's” Togt 1884 af"]
['Eug. Warming og Th. Holm.']	['Eug. Warming og Th. Holm.']
['DEN DANSKE ARKTISKE STATION.']	['DEN DANSKE ARKTISKE STATION.']
['DISKO. GRØNLAND.']	['DISKO. GRØNLAND.']
['Amalie arenicola (Rute) Jel.']	['Arabis arenicola (Rich) Gel.']
['GROENL. OCCid.']	['GROENL. OCCID.']
["Patorfik, 70° 42'"]	["Patorfik, 70° 42'"]
['27. Juli 1921.']	['27. Juli 1921']
['leg. A. Erling Porsild.']	['leg. A. Erling Porsild.']
['Dansk geologisk Undersøgelse af Grønland 1879,']	['Dansk geologisk Undersøgelse af Grønland 1879.']
['Alopecurus alpinus. Sm.']	['Alopecurus alpinus. Sm.']
['Keqertarsuit, Mundingen af N. Strømfjord-']	['Kekertarsuit, Mundingen af N. Strömfjord.']
['5. Juli:']	['5. Juli.']
['A. Kornerup.']	['A. Kornerup.']
['Plantae groenlandicae']	['Plantae groenlandicae']
['a Museo botanico Hauniensi distributae.']	['a Museo botanico Hauniensi distributae.']
['Expeditio Danica in Groenlandiam orientalem 1891 §2.000']	['Expeditio Danica in Groenlandiam orientalem [1891 92]. 1806']
['Cochlearia officinalisk']	['Cochlearia officinalis L.']
['A. Gram Pederaad maa Gæst.']	['B groenlandica Gelert.']
['Ley. N. Hartz ad Demholme']	['Leg. N. Hartz ad Dunholm']
['Juli 1900']	['Juli 1806']
['Botanic Museum of the University, Copenhagen']	['Botanic Museum of the University, Copenhagen']
['Greenland Plants']	['Greenland Plants']
['No 18. Phleum alpinum L.']	['No 18.  Phleum alpinum L.']
['lat. Kudartorfik']	['Lat. Kuiartorfik']
['Long.']	['Long.']
['Alt.']	['Alt.']
['Loc.']	['Loc.']
['Date: 12.VII.1899.']	['Date: 12.VII.1899.']
['Det. Johs. Grøntved']	['Det. Johs.Gröntved']
['leg. J.Lindhard']	['Leg. J.Lindhard']
['Husortorf Ch 12/7 99.']	['Kuiartorfik. 12/7/99.']
['Pleum alpinum 2.']	['Phleum alpinum L.']
['Lindkend.']	['Lindhard.']
['Carl rostrata Stokes x C. salatilis L.']	['Care rostrata Stokes X C. saxatilis L.']
['10.5,79']	['10.5.1979']
['Det. Jon Feilberg']	['Det. Jon Feilberg']
['Botanic Museum of the University, Copenhagen']	['Botanic Museum of the University, Copenhagen']
['Greenland Plants']	['Greenland Plants']
['No 75. Carex rostrata Stokes']	['No 75. Craex rostrata Stokes']
['Lat.']	['Lat.']
['Long.']	['Long.']
['Alt. Mose 13.']	['Alt.  Mose 13.']
['Loc. Tasiusssaq']	['Loc. Tasiussaq']
['Date: 1926.']	['Date:  1926.']
['Det. Johs. Grøntved']	['Det. Johs.Gröntved']
['leg. Kn.Jossen']	['Leg. Kn.Jessen']
['Plantae groenlandicae']	['Plantae groenlandicae']
['a Museo botanico Hauniensi distributae.']	['a Museo botanico Hauniensi distributae.']
['Polypodium Dryopteris L.']	['Polypodium dryopteris L.']
['Groenl. anstr.: Taserministeriet i Tasermiut.']	['Groenl. austr.: Tasermiutsiak; Tasermiut.']
['legit N. Hartz an. 1889. 5/9.']	['logit N. Hartz an. 1889. 5/9.']
['Museum botanicum Hauniense.']	['Museum botanicum Hauniense.']
['Carp Grolenoui Gang x. rig i de Jord.']	['Carex goodenowii Gay x rigida Good.']
['(C. Groulands ca Lange.)']	['(C. Groenlandica Lange.)']
['determ: C. Ostenfald 18m.']	['determ: C.Ostenfeldt 1899.']
['- J. Vahl, Aug. 1828.']	['legit: J.Vahl, Aug. 1828.']
['Ugrøul; en lecis henmidis Tralko.']	['V Grönl: in locis humidis Igaliko.']
["68° 46' N 53°07' W"]	["68°46' N 53°07' W"]
['Plantae groenlandicae']	['Plantae groenlandicae']
['a Museo botanico Hauniensi distributae.']	['a Museo botanico Hauniensi distributae.']
['Agrostis rubra']	['agrostis rubra']
['oceic].']	['occid.']
['GROENL. 0RENNT.:']	['GROENL. [ORIEN]T.:']
['Kullen 26/8. 1897']	['Kullen 26/8. 1897']
["sat bor 60° 45'"]	["Lat. Bor. 68°45'"]
['leg. C. Kruuse.']	['leg. C. Kruuse.']
['Herbarium musei botanici Hauniensis.']	['Herbarium muse botanici Hauniensis']
['Equisetum scirpoides Micha.']	['Equisetum scirpoides Michx.']
['Equifolum reptans']	['equisetum reptans']
['Holsteiborg.']	['Holsteinborg.']
['Nordell 1844.']	['Holboll 1844.']
['Eirb. Johlængs']	['Herb. Job.Lange']
['Aspidium Lønchitis']	['Aspidium lonchitis']
['in boes urrigatis haberechtis']	['in locis irrigatis suboccuttis']
['linus Kangerthastrufuk (Kobbekørsel.)']	['sinus Kangerdluarssuk (Kobbefjord.)']
['1830 Juli.']	['1830 Juli.']
['Hierochloe orthantha Th. S.']	['Hierochloe orthantha Th. S.']
['determ. Thorv. Sørensen fg 5c']	['determ. Thorv. Sørensen 1952']
['Universitetets botaniske Museum, København.']	['Universitetets botaniske Museum, København.']
['Museum botanicum Hauniense.']	['Museum botanicum hauniense.']
['Arctic Plants']	['Arctic Plants']
['collected by the MORAVIAN BRETHREN 1847 - 1856.']	['collected by the MORAVIAN BRETHREN 1847 - 1856.']
['(See M. P Porsild: Stray Contributions to the Flora of Green-']	['(See M. P Porsild: Stray Contributions to the Flora of Green-']
['land XII. - Medd. om Gronl. Bd. 93, No. 3 (1935), p. 84-94)']	['land XII. - Medd. om Gronl. Bd. 93, No. 3 (1935), p. 84-94)']
['Hierochloë alpina (Willd.) Roemer & Schultes']	['Hierochloë alpina (WILLD.) ROEMER & SCHULTES']
['ssp. orthantha (Sørensen) G. Weim.']	['ssp. orthantha (SORENSEN) G. WEIM.']
['Det. Gunnar Weimarck 1970']	['Det. Gunnar Weimarck  1970']
['Weimarck, G. 1971.½tering and Taxonomy of']	['WEIMARCK, G. 1971. Variation and Taxonomy of']
['Hierochloë (Gramineae) in the Northern Hemi-']	['Hierochloë (Gramineae) in  the Northern Hemi-']
['sphere. – Bot. Notiser 124: 129—175.']	['sphere. - Bot. Notiser 124: 129-175.']
['Hierorklva alpina Roen Albert']	['Hierochloe alpina Roem et Schult']
['Holms alpinus L.']	['Holcus alpinus L.']
['Grønland.']	['Gronland.']
['1849']	['1849']
['Rig J. Grøf 3. St.U.']	['Rug Fr. Graf. 3, J. H. W.']
['Hierorkleva alpina Svenet Smed']	['Hierochloe alpina Roem et Schult']
['Holms alpinus fra']	['Holcus alpinus Lin']
['Grønland']	['Gronland']
['Cystopteris fragilis(d.) Beruh.']	['Cystopteris fragilis (L.) Bernh']
['enend. Tim.']	['emend. Lim']
['1951 derom. Kai Larsen']	['1951 determ. Kai Larsen']
['DEN DANSKE ARKTISKE STATION.']	['DEN DANSKE ARKTISKE STATION']
['DISKO. GRØNLAND.']	['DISKO. GRØNLAND.']
['Cystopsteris fragilisk L. Bernh.']	['Cystopteris fragilis (L.) Berkh']
['Disko, Bjellemfjord, Kuanit, 63" E.']	['Disko, Mellemfjord, Kuanit, 69°43']
['9, VIII 1911.']	['9.XIII 1911.']
['leg. Morten P. Porsild.']	['leg. Morten P. Porsild.']
['& Thorbjørn Forsild.']	['& Thorbjorn Porsild.']
['Museum Botanicum Ha']	['Museum Botanicum Ha']
['(Label for data hanc']	['(Label for data hano']
['Number']	['Number']
['Specimen EQR']	['Specimen EQAR']
['Locality 6255005']	['Locality 62555005']
['Altitude']	['Altitude']
['Date 16061878']	['Date 16061878']
['Collector Ak']	['Collector AK']
['W.C. 1: 39']	['M.G. 1 : 39  6255 5005']
['det. 31. 3.79 Ø Lars KIIim-Nielsen']	['det. 31. 3.1971  Lars Klilm - Nielsen']
['Dansk geologisk Undersøgelse af Grønland 18 %,']	['Dansk geologisk Undersegelse af Grønland 1878,']
['2. Exviselserne avende var alpelse']	['2. Equisetum arvense var. alpestre']
['Udskabet']	['Wahlenb']
['Bjørnesund 63°']	['Bjørnesund 63°']
['16 Juni.']	['16 Juni.']
['A. Kornerup.']	['A. Kornerup.']
['Museum Botanicum Hauniense']	['Museum Botanicum Hauniense']
['TreArsekspeditionen til Christian den X’s land 1981—33']	["Treårsekspeditionen til Christian den X's land 1931-33"]
['Northeast Greenland']	['. Northeast Greenland']
['No.']	['No.']
['Saxifraga aizoides Lo']	['Saxifraga aizoides L.']
['Wollastone Foreland: Kap Giesecke']	['Wollastone Foreland: Kap Giesecke']
["Lat. 74° 30' N., Long. 21° 40' W."]	["Lat. 74°30' N., Long. 21°40' W."]
['1. aug. 1933']	['1. aug. 1933']
['Leg. Paul Gelting']	['Leg. Paul Gelting']
['Det. Kjeld Holmen']	['Det. Kjeld Holmen']
['Un 02,201 - 5']	['Un 02,201-5']
['Papaver dahlianum Nordh.']	['Papaver dahlianum Nordh.']
['Det. Heidi Solstad, Reidar Elven']	['Det. Heidi Solstad, Reidar Elven  Oct. 2013']
['The Norwegian Expedition to East-Greenland 1976']	['THE NORWEGIAN EXPEDITION TO EAST-GREENLAND 1930']
['Papaver radicatum Rottb.']	['Papaver radicatum Rottb.']
['Wollastone Foreland: Landingsdalen']	['Wollastone Foreland: Landingsdalen']
['21. juli 1930']	['21. juli 1930']
['leg. Jakob Vaage']	['leg. Jakob Vaage']
['Dansk geologisk Undersøgelse af Grønland 1879']	['Dansk geologisk Undersøgelse af Grønland 1879']
['Luzula hyperborea Rbdr.']	['Lūzūla hyperborea. RBr.']
['Kingigtok, N. Strømfjord, 6745 n. Br.']	["Kingigtok, N.Strömfjord, 67°45' n. Br."]
['600 kr - 1900 øre']	["600 m = 1900'0.H"]
['12. Juli:']	['12. Juli']
['A. Kornerup.']	['A. Kornerup.']
['Herb. Joh:Lange']	['Herb. Joh.Lange']
['Paa præterie l. var domestica Læsted.']	['Poa pratensis L. var. domestica Laestad.']
['Opkommen af Frø fra Grønland']	['Opsommen af Tiö fu Grönland']
['Det Have 1860,']	['Bot Have 1860.']
['Asplenium viride Hud.']	['Asplenium viride Huds.']
['in rupibus en reresse intima sinud']	['In rupibus in recessu intima sinus']
['Kongerhusets Prope Frederikshaab']	['Kangerdluarssuk prope Frederikshaab.']
['5/1 1886. Groenlandia merid']	['16/8 1886. Groenlandia merid.']
['Th. Holm.']	['Th. Holm.']
['1']	['1']
['Potentilla tridentata']	['Potentilla tridentata']
['Vornok 4/8 1890']	["K'ornok 4/8 1890"]
['P.A. Sørensen']	['P.A.Sórensen']
["66° 43' N 4"]	["60°43' N"]
['Prikliet S1.']	['Prikket S1.']
['Lyscopodium alpinnaad Ⅰ']	['Lycopodium alpinum L.']
['Johan frab 1898']	['Julianehaab 1848.']
['Hib. E. Rasmussen B. Kjær']	['Hb. E. ROSTRUP.  B. Kruse']
['Plantae groenlandicae']	['Plantae groenlandicae']
['a Museo botanico Hauniensi distributae.']	['a Museo botanico Hauniensi distributae.']
['Rubus Chamaemorus L.']	['Rubus chamaemorus L.']
['I Mænger ved en stor Klippeblok']	['I Mængor ved en stor Klippeblok']
['Julianebaab']	['Julianehaab']
['legit Dr. L. Kolderup Rosenvinge a. 1888. 21 Aug.']	['legit Dr. L. Kolderup Rosenvinge a. 1888. 21 aug.']
['Botrychium boreale Milde']	['Botrychium boreale Milde']
['Petersen O. Gelert 1897']	['determ. O Gelert 1897']
['Plantae groenlandicae']	['Plantae groenlandicae']
['a Museo botanico Hauniensi distributae.']	['a Museo botanico Hauniensi distributae.']
['Botrychium Linaria (L. Sa.']	['Botrychium lunaria (L.) Sw.']
['f. incisa Milde']	['f. incisa Milde']
['Groenr. anstr: Ningnaa Tasersuak - Tasermiut.']	['Groenl. austr.: Kingua Tasersūak - Tasermiut.']
['legit N. Hartz an. 1889. 2/9.']	['legit N. Hartz an. 1889. 219.']
['Egnesetum arvense.']	['Equisetum arvense']
['Gaardmand 1838.']	['Gronland 1838.']
['Vahl.']	['Vahl.']
['Draba aurea M.Vahl']	['Draba aurea M.Vahl']
['29.12.74. Det. Jon Feilberg']	['29.12.79  Det. Jon Feilberg']
['Draba anra x dansine']	['Draba aurea x danriu']
['determ. Elis. Eksen']	['determ. Elis. Eksmanux']
['Draba anrea M. Vahl']	['Draba aurea M. Vahl']
['A. O. 1925']	['ett.o.1925']
['Flora Groenlandica.']	['Flora Groenlandica.']
['Arvbo incana L. (2)']	['Draba incana L. (?)']
['Nårsson (Andgrøm) Amt Skrænt langs Boadebarnes']	['Narssak (Nordpróven): Sint Skrænt langs Baadehavnen']
['(imellem Elvns Udløb og Udstyrerboligen) 17/57 1900.']	['imellem Elvens Udlób og Udstedsbestynsboligen). 17/7 1900.']
['leg. Gustav Meldorf.']	['leg. Gustav Meldorf.']
['Melandrium offre J. Vahl']	['Melandrium affine J. Vahl']
['Det. Bent Fredskild']	['Det. Bent Fredskild']
['Jon. 1988']	['Jan.1988']
['DEN DANSKE ARKTISKE STATION.']	['DEN DANSKE ARKTISKE STATION.']
['DISKO. GRØNLAND.']	['DISKO. GRØNLAND.']
['Melandrium triflorum (R. Br.) J. Vahl']	['Melandrium triflorum (R. Br.) J.Vahl']
['Vest Grønland, Igdløreuit 71° 24']	["Vest Grönland, Igdlorsuit. 71°14'"]
['5 VIII° 1311.']	['5 VIII 1911']
['leg. Morten P. Porsild.']	['leg. Morten P. Porsild.']
['& Thorbjørn Hørvald']	['& Thorbjørn Porsild']
['Museum B.']	['Museum B']
['(Label 1']	['(Label 1']
['Number']	['Number']
['Specimen EQSC']	['Specimen EQSC']
['Locality 69175 33']	['Locality 6917533']
['Altitude']	['Altitude']
['Date 0809186']	['Date 0809186']
['Collector RB']	['Collector RB']
['6917 530']	['6917 5330']
['det. Arn1/ 97f Lars Kliim-Nielsen']	['det. april 1971 Lars Kliim - Nielsen']
['2']	['2']
['Museum botanicum Hauniense.']	['Museum botanicum Hauniense.']
['Equisetum scirpoides Mielip-']	['Equisetūm scirpoides Michx']
['determ: Ogelert 1897']	['determ: O Gelerl 1897']
['legit: R Brown 8/9 67']	['legit: R Brown 8/9 67']
['Groenlandia: Disco, Lyngmarken.']	['Groenlandia: Disco, Lyngmarken']
['Plantae groenlandicae']	['Plantae groenlandicae']
['a Museo botanico Hauniensi distributae.']	['a Museo botanico Hauniensi distributae.']
['Expeditio Danica in Groenlandiam orientalem 1891—92.']	['Expeditio Danica in Groenlandiam orientalem 1891-92.']
['Carex rariflora Sm.']	['Carex rariflora Sm.']
['tav N. Hansen md. Skoresby, Sund pr. Røde Ø']	['Leg. N. Hartz ad Scoresby Sund pr. Róde Ø.']
['7028 Nr 2825/8 1891']	["70°28'N 28°05'W  16/8 1891"]
['Herbarium musei botanici Hauniensis.']	['Herbarium muse botanici Hauniensis.']
['Elyna Bellardi (All.)']	['Elyna Bellardi (All.)']
['ie leies Enkes']	['in locis siccis']
['Igalike']	['Igaliko']
['1828 4 Fag.']	['1828 4 Aug.']
['J. Vahl.']	['J.Vahl.']
['Jern standamte f.']	['derm. Stamiautr A.']
['DEN DANSKE ARKTISKE STATION.']	['DEN DANSKE ARKTISKE STATION.']
['DISKO. GRØNLAND.']	['DISKO. GRØNLAND.']
['Care misandra Rbdr.']	['Carex misandra RBr.']
['Hordkejsten af N. Skp. ud for Skolevæsenet']	['Nordkysten af N. Strfj. ud for. Ekaluarssuit.']
["67° 35'"]	["67°35'"]
['10 Aug. 1918. E.L.M. P.P.']	['10 aug. 1918.  leg E. & M.P.P.']
['Polypodium Phegopteris']	['Polypodium phegopteris']
['in Louis Tubercøttes henses Amoral-']	['in locis subvicuttis sinus Amarak']
['1830 Dag.']	['1830 Aug.']
['Grønland. Lig J. Vahl.']	['Grönland. Leg. J. Vahl.']
['Universitetets botaniske Museum, København.']	['Universitetets botaniske Museum, København.']
['Museum botanicum Hauniense.']	['Museum botanicum Hauniense.']
['„Danmark” Expeditionen, 1906-1908. 741']	['„Danmark" Expeditionen, 1906-1908. 741']
['Jensens castanens L.']	['Juncus castaneus L.']
['det. C. U.']	['det. etto.']
['groenlandia bor-orient. Detiskæret']	['Groenlandia bor.-orient.: Basiskæret.']
['31 Aug. 1907. Andr. Lundgger']	['31 aug 1907  leg. Andr. Lundager.']
['Lycopodium alpivum']	['Lycopodium alpinum']
['Grørland 1886 samlet af']	['Grönland 1886 Facenluk af']
['Niels Kolderup Rosenøvningen']	['(something). Kolderup Rosenvinge.']
['(Laampistis lappestaare Lge']	['Calamagrostis hyperbore Lge']
['determ. Thorv. Sørensen 1852']	['determ. Thorv. Sørensen 1952']
['DEN DANSKE ARKTISKE STATION.']	['DEN DANSKE ARKTISKE STATION.']
['DISKO, GRØNLAND.']	['DISKO, GRØNLAND.']
['Calamagrostis hyperborea Lange']	['Calamagrostis Lyperborea Lange']
["Syd-Grønl. Taserssp Qingua, Tasermiut-Fjord, 60° 16' N."]	["Syd-Grønl. Taserssûp Qingua, Tasermiut-Fjord, 60° 16' N."]
['27. - 28. Juli 1925. A.E.Porsild & M.P. Porsild.']	['27.--28. Juli 1925.  A. E. Porsild & M. P. Porsild.']
['Botrychum boreale Miede']	['Botrychium boreale Milde']
['Petersen Oleslere 1897.']	['determ. OGelerl 1897.']
['Botrychium lunaria. Sv.']	['Botrychium lunaria. Sv.']
["F Groenlandia 60° - 72° 48'"]	["E Groenlandia 60° - 72°48'."]
['J. Vahls']	['J. Vahl.']
['Botrychium funaria']	['Botrychium lunaria']
['in Louis graminar fra Kor-']	['in locis graminosis Kor']
['Johannes Tosformiut']	['fvak sinnus Tesfarmiut']
['1828 Juli.']	['1828 Juli.']
['Herbarium musei botanici Hauniensis.']	['Herbarium muse botanici Hauniensis.']
['Arctophila effusa Lge.']	['Arctophila effusa Lge.']
['Det. Joh. Lange 1885.']	['Det. Joh. Lange 1885.']
['Paa Endet']	['Poa sudetiia']
['pendulina.']	['pendulina']
['in lois humidis Godthaab']	['in locis humidis Godthaab']
['1830 Juli']	['1830 Juli']
['Dansk geologisk og geografisk Undersøgelse']	['Dansk geologisk og geografisk Undersøgelse']
['af Grønland 1884']	['af Grønland 1884']
['Carex rigide var infuscata Drej.']	['Carex rigida var. infuscata Drej.']
['S. Grønl. Ingitait Fjord (61° 9 1)']	["Ø. Grønl. Ingitait Fjord (61°9')"]
['23 Aug. lg. P. Herlin']	['23 Aug. leg. P. Eberlin']
cer: 0.11934900542495479
wer: 0.3745532523230879
